id,day,date,positive,recovered,death,negative,new_ODP,new_PDP,finished_ODP,finished_PDP,cumulative_ODP,cumulative_PDP,cumulative_finished_ODP,cumulative_finished_PDP,Rt,Rt_upper,Rt_lower
1,1,2020-03-22 00:00:00,0,0,0,0,10,7,0,0,10,7,0,0,,,
2,2,2020-03-23 00:00:00,0,0,0,3,10,5,0,0,20,12,0,0,,,
3,3,2020-03-24 00:00:00,0,0,0,0,4,5,0,0,24,17,0,0,,,
4,4,2020-03-25 00:00:00,0,0,0,0,19,2,0,0,43,19,0,0,,,
5,5,2020-03-26 00:00:00,1,0,0,1,3,0,1,0,46,19,1,0,,,
6,6,2020-03-27 00:00:00,0,0,0,1,1,0,0,0,47,19,1,0,,,
7,7,2020-03-28 00:00:00,1,0,0,0,3,9,1,0,50,28,2,0,,,
8,8,2020-03-29 00:00:00,0,0,0,0,15,0,3,0,65,28,5,0,,,
9,9,2020-03-30 00:00:00,0,0,1,0,43,1,5,0,108,29,10,0,,,
10,10,2020-03-31 00:00:00,0,0,0,1,11,0,0,0,119,29,10,0,,,
11,11,2020-04-01 00:00:00,0,0,0,2,8,0,5,3,127,29,15,3,,,
12,12,2020-04-02 00:00:00,0,0,0,0,10,2,8,0,137,31,23,3,,,
13,13,2020-04-03 00:00:00,2,0,0,0,7,3,9,4,144,34,32,7,,,
14,14,2020-04-04 00:00:00,0,0,1,0,7,1,3,1,151,35,35,8,,,
15,15,2020-04-05 00:00:00,0,0,0,0,5,1,4,0,156,36,39,8,,,
16,16,2020-04-06 00:00:00,1,0,0,1,262,5,11,1,418,41,50,9,,,
17,17,2020-04-07 00:00:00,0,0,0,0,9,1,16,0,427,42,66,9,,,
18,18,2020-04-08 00:00:00,1,2,0,2,15,7,31,2,442,49,97,11,2.68,3.84,1.71
19,19,2020-04-09 00:00:00,0,0,0,2,5,1,34,4,447,50,131,15,2.16,3.09,1.38
20,20,2020-04-10 00:00:00,8,0,0,2,7,2,40,5,454,52,171,20,0.96,1.55,0.5
21,21,2020-04-11 00:00:00,5,0,0,5,10,3,3,10,464,55,174,30,0.56,0.98,0.24
22,22,2020-04-12 00:00:00,0,0,0,4,12,1,7,3,476,56,181,33,0.77,1.23,0.4
23,23,2020-04-13 00:00:00,0,0,1,0,5,2,13,0,481,58,194,33,0.74,1.19,0.39
24,24,2020-04-14 00:00:00,0,0,0,0,6,2,18,0,487,60,212,33,0.75,1.2,0.39
25,25,2020-04-15 00:00:00,3,0,0,2,14,3,61,4,501,63,273,37,0.69,1.14,0.34
26,26,2020-04-16 00:00:00,0,0,0,1,3,5,7,2,504,68,280,39,0.73,1.2,0.36
27,27,2020-04-17 00:00:00,0,0,0,0,58,4,9,0,562,72,289,39,1.07,1.64,0.6
28,28,2020-04-18 00:00:00,2,0,0,0,10,3,119,2,572,75,408,41,1.34,2,0.79
29,29,2020-04-19 00:00:00,3,0,0,0,24,3,7,2,596,78,415,43,1.08,1.7,0.59
30,30,2020-04-20 00:00:00,0,0,0,1,11,4,17,2,607,82,432,45,1.11,1.74,0.6
31,31,2020-04-21 00:00:00,0,1,0,2,11,5,7,3,618,87,439,48,1.78,2.57,1.12
32,32,2020-04-22 00:00:00,2,0,0,7,8,0,6,2,626,87,445,50,2.09,2.93,1.37
33,33,2020-04-23 00:00:00,0,0,0,2,9,4,11,2,635,91,456,52,2.04,2.86,1.33
34,34,2020-04-24 00:00:00,3,0,0,0,9,8,16,3,644,99,472,55,1.63,2.35,1.02
35,35,2020-04-25 00:00:00,4,0,0,2,12,4,6,4,656,103,478,59,2.25,3.05,1.55
36,36,2020-04-26 00:00:00,0,0,0,1,17,3,4,1,673,106,482,60,2.05,2.78,1.41
37,37,2020-04-27 00:00:00,0,0,0,0,5,2,10,0,678,108,492,60,1.87,2.53,1.29
38,38,2020-04-28 00:00:00,6,5,0,4,13,1,4,5,691,109,496,65,2.05,2.71,1.47
39,39,2020-04-29 00:00:00,5,0,0,0,10,3,6,0,701,112,502,65,1.54,2.09,1.06
40,40,2020-04-30 00:00:00,0,0,0,1,1,1,11,5,702,113,513,70,1.69,2.24,1.21
41,41,2020-05-01 00:00:00,0,3,0,1,3,0,7,1,705,113,520,71,1.55,2.06,1.11
42,42,2020-05-02 00:00:00,12,0,0,0,16,1,39,3,721,114,559,74,0.84,1.21,0.54
43,43,2020-05-03 00:00:00,0,0,0,2,3,6,4,1,724,120,563,75,1.16,1.57,0.81
44,44,2020-05-04 00:00:00,0,0,0,1,12,7,4,1,736,127,567,76,1.11,1.5,0.77
45,45,2020-05-05 00:00:00,11,0,0,8,4,3,18,9,740,130,585,85,1.12,1.51,0.79
46,46,2020-05-06 00:00:00,0,1,0,0,9,0,22,0,749,130,607,85,1.37,1.79,1
47,47,2020-05-07 00:00:00,5,0,0,0,1,0,13,4,750,130,620,89,1.57,2.02,1.17
48,48,2020-05-08 00:00:00,0,0,0,13,6,3,9,12,756,133,629,101,1.6,2.04,1.2
49,49,2020-05-09 00:00:00,0,0,0,2,32,9,11,1,788,142,640,102,1.59,2.03,1.2
50,50,2020-05-10 00:00:00,8,0,0,0,8,2,3,1,796,144,643,103,1.29,1.68,0.94
51,51,2020-05-11 00:00:00,0,1,0,6,11,2,21,7,807,146,664,110,1.21,1.58,0.89
52,52,2020-05-12 00:00:00,12,0,0,0,17,0,13,1,824,146,677,111,0.73,1.01,0.49
53,53,2020-05-13 00:00:00,6,7,0,2,9,1,8,4,833,147,685,115,0.5,0.72,0.31
54,54,2020-05-14 00:00:00,10,1,1,3,36,4,6,7,869,151,691,122,0.23,0.38,0.11
55,55,2020-05-15 00:00:00,1,0,0,2,26,4,3,3,895,155,694,125,0.19,0.34,0.08
56,56,2020-05-16 00:00:00,1,1,0,7,10,6,3,5,905,161,697,130,0.27,0.45,0.14
57,57,2020-05-17 00:00:00,2,2,0,0,39,1,4,3,944,162,701,133,0.22,0.39,0.1
58,58,2020-05-18 00:00:00,0,2,0,3,16,0,5,4,960,162,706,137,0.25,0.44,0.11
59,59,2020-05-19 17:58:12,0,0,0,2,2,1,0,0,962,163,706,137,0.29,0.52,0.13
60,60,2020-05-20 17:54:34,0,0,0,3,22,3,0,3,984,166,706,140,0.35,0.61,0.15
61,61,2020-05-21 16:48:06,2,11,0,6,0,2,3,7,984,168,709,147,0.69,1.08,0.37
62,62,2020-05-22 16:55:13,0,0,0,0,15,2,5,0,999,170,714,147,0.82,1.29,0.45
63,63,2020-05-23 18:03:44,3,0,0,0,1,1,0,4,1000,171,714,151,0.67,1.14,0.32
64,64,2020-05-24 18:03:44,0,9,0,0,0,0,0,0,1000,171,714,151,0.98,1.57,0.51
65,65,2020-05-25 18:35:29,0,0,0,1,0,0,4,2,1000,171,718,153,1.06,1.7,0.55
66,66,2020-05-26 16:30:43,0,2,0,1,7,2,23,1,1007,173,741,154,1.12,1.79,0.58
67,67,2020-05-27 16:11:20,0,2,0,1,4,5,4,0,1011,178,745,154,1.28,2,0.69
68,68,2020-05-28 17:09:29,6,2,0,9,17,1,7,8,1028,179,752,162,0.52,1,0.18
69,69,2020-05-29 15:50:19,0,0,0,3,5,1,2,1,1033,180,754,163,1.42,2.18,0.79
70,70,2020-05-30 17:28:19,0,0,0,2,27,4,7,2,1060,184,761,165,1.8,2.66,1.09
71,71,2020-05-31 16:09:21,2,9,0,2,4,1,0,2,1064,185,761,167,4.15,5.43,3.02
72,72,2020-06-01 16:56:21,0,0,0,1,1,0,2,3,1065,185,763,170,4.1,5.36,2.98
73,73,2020-06-02 16:40:21,0,0,0,0,1,1,4,0,1066,186,767,170,3.76,4.92,2.74
74,74,2020-06-03 19:40:21,1,3,0,1,2,3,3,3,1068,189,770,173,3.03,3.98,2.2
75,75,2020-06-04 17:17:21,0,6,0,0,2,0,3,0,1070,189,773,173,2.42,3.18,1.75
76,76,2020-06-05 17:35:21,7,8,0,1,8,1,31,1,1078,190,804,174,1.52,2.06,1.05
77,77,2020-06-06 17:29:21,3,8,0,0,5,5,31,1,1083,195,835,175,1.6,2.1,1.15
78,78,2020-06-07 18:29:21,20,7,0,20,8,1,0,0,1091,196,835,175,0.56,0.85,0.32
79,79,2020-06-08 17:50:21,0,0,0,0,7,1,2,0,1098,197,837,175,0.56,0.84,0.33
80,80,2020-06-09 18:15:21,0,0,0,0,0,2,2,0,1098,199,839,175,0.58,0.85,0.35
81,81,2020-06-10 18:07:22,0,1,0,0,28,2,8,0,1126,201,847,175,0.58,0.85,0.35
82,82,2020-06-11 18:00:22,0,1,0,3,10,6,7,3,1136,207,854,178,0.6,0.89,0.36
83,83,2020-06-12 17:23:12,0,0,0,0,13,1,2,3,1149,208,856,181,0.69,1,0.42
84,84,2020-06-13 18:28:12,9,1,0,3,8,2,2,2,1157,210,858,183,0.3,0.52,0.13
85,85,2020-06-14 16:56:52,2,19,0,5,9,2,2,5,1166,212,860,188,0.21,0.41,0.07
86,86,2020-06-15 16:42:52,1,6,0,3,0,2,27,3,1166,214,887,191,0.35,0.61,0.15
87,87,2020-06-16 16:50:52,1,4,0,3,9,1,7,4,1175,215,894,195,0.51,0.84,0.25
88,88,2020-06-17 16:57:52,0,4,0,1,4,5,2,3,1179,220,896,198,0.65,1.04,0.34
89,89,2020-06-18 16:49:30,0,1,0,5,7,2,54,7,1186,222,950,205,0.82,1.29,0.44
90,90,2020-06-19 17:15:30,1,0,0,1,2,4,3,5,1188,226,953,210,1.02,1.58,0.57
91,91,2020-06-20 16:21:30,0,1,0,5,12,0,9,3,1200,226,962,213,1.24,1.87,0.71
92,92,2020-06-21 17:33:30,0,1,0,0,2,2,2,6,1202,228,964,219,1.54,2.28,0.93
93,93,2020-06-22 17:33:30,3,0,0,6,2,1,0,0,1204,229,964,219,1.25,1.92,0.7
94,94,2020-06-23 17:41:30,3,8,0,9,7,2,18,3,1211,231,982,222,0.9,1.48,0.45
95,95,2020-06-24 17:04:30,1,1,1,0,5,5,1,0,1216,236,983,222,0.76,1.29,0.36
96,96,2020-06-25 16:14:30,1,4,0,0,11,2,8,0,1227,238,991,222,0.63,1.11,0.28
97,97,2020-06-26 18:08:35,2,2,0,1,1,4,24,2,1228,242,1015,224,0.42,0.81,0.14
98,98,2020-06-27 18:01:35,1,5,0,1,0,1,5,1,1228,243,1020,225,0.85,1.4,0.42
99,99,2020-06-28 16:38:35,2,1,0,0,21,6,4,0,1249,249,1024,225,0.67,1.18,0.29
100,100,2020-06-29 16:50:35,0,0,0,0,6,4,4,0,1255,253,1028,225,0.72,1.26,0.31
101,101,2020-06-30 16:37:35,0,3,0,8,3,1,5,10,1258,254,1033,235,0.78,1.36,0.34
102,102,2020-07-01 16:45:35,0,1,0,2,34,3,42,1,1292,257,1075,236,1.11,1.83,0.55
103,103,2020-07-02 19:30:35,0,1,0,0,0,1,101,3,1292,258,1176,239,1.19,1.95,0.59
104,104,2020-07-03 16:50:35,0,1,0,0,0,0,9,2,1292,258,1185,241,1.25,2.05,0.62
105,105,2020-07-04 17:03:35,5,2,1,6,29,8,9,5,1321,266,1194,246,0.48,1.01,0.13
106,106,2020-07-05 16:45:35,0,2,0,0,2,1,12,0,1323,267,1206,246,0.48,1.02,0.13
107,107,2020-07-06 17:02:35,0,0,0,3,1,4,0,4,1324,271,1206,250,0.49,1.02,0.13
108,108,2020-07-07 16:15:35,0,1,0,0,1,1,0,1,1325,272,1206,251,0.67,1.3,0.23
109,109,2020-07-08 17:45:35,2,0,0,0,6,7,13,4,1331,279,1219,255,0.53,1.12,0.15
110,110,2020-07-09 17:49:35,0,0,0,2,0,3,2,1,1331,282,1221,256,0.58,1.22,0.16
111,111,2020-07-10 16:49:35,0,0,0,3,10,2,6,4,1341,284,1227,260,0.65,1.35,0.18
112,112,2020-07-11 17:31:35,0,1,0,0,1,2,1,0,1342,286,1228,260,0.72,1.51,0.2
113,113,2020-07-12 17:42:35,0,1,0,5,4,1,1,8,1346,287,1229,268,1.06,2.06,0.36
114,114,2020-07-13 16:40:35,0,0,0,0,1,1,3,0,1347,288,1232,268,1.18,2.29,0.4
115,115,2020-07-14 17:40:35,1,2,0,0,3,0,3,2,1350,288,1235,270,0.96,2.02,0.26
116,116,2020-07-15 16:58:35,1,7,0,0,6,3,0,3,1356,291,1235,273,0.68,1.62,0.12
117,117,2020-07-16 17:03:35,0,0,0,0,3,2,3,4,1359,293,1238,277,2.12,3.71,0.92
118,118,2020-07-17 17:00:35,0,0,0,0,11,0,1,2,1370,293,1239,279,2.55,4.31,1.2
119,119,2020-07-18 17:22:35,0,0,0,0,5,3,5,2,1375,296,1244,281,2.6,4.4,1.22
120,120,2020-07-19 16:51:35,1,1,0,0,2,0,9,0,1377,296,1253,281,2.52,4.26,1.18
121,121,2020-07-20 17:38:35,0,0,0,0,0,0,0,0,1377,296,1253,281,2.29,3.88,1.08
122,122,2020-07-21 16:27:35,0,2,0,0,0,0,0,0,1377,296,1253,281,3.18,4.9,1.78
123,123,2020-07-22 16:28:35,0,3,0,0,0,0,0,0,1377,296,1253,281,3.05,4.62,1.76
124,124,2020-07-23 16:29:35,4,3,0,0,0,0,0,0,1377,296,1253,281,1.78,2.93,0.89
125,125,2020-07-24 16:25:35,1,0,0,0,0,0,0,0,1377,296,1253,281,1.35,2.29,0.64
126,126,2020-07-25 20:15:35,0,1,0,0,0,0,0,0,1377,296,1253,281,1.18,2,0.56
127,127,2020-07-26 17:06:35,1,0,1,0,0,0,0,0,1377,296,1253,281,1.84,2.79,1.06
128,128,2020-07-27 16:11:35,0,0,0,0,0,0,0,0,1377,296,1253,281,1.73,2.63,1
129,129,2020-07-28 16:28:35,4,3,0,0,0,0,0,0,1377,296,1253,281,1.11,1.83,0.55
130,130,2020-07-29 16:45:35,1,0,0,0,0,0,0,0,1377,296,1253,281,1.2,1.92,0.62
131,131,2020-07-30 17:05:35,0,0,0,0,0,0,0,0,1377,296,1253,281,1.14,1.84,0.6
132,132,2020-07-31 15:59:35,0,0,0,0,0,0,0,0,1377,296,1253,281,1.23,1.93,0.67
133,133,2020-08-01 15:59:35,0,1,0,0,0,0,0,0,1377,296,1253,281,1.2,1.89,0.65
134,134,2020-08-02 17:25:35,6,0,0,0,0,0,0,0,1377,296,1253,281,0.48,0.92,0.16
135,135,2020-08-03 16:50:35,0,0,0,0,0,0,0,0,1377,296,1253,281,0.47,0.91,0.16
136,136,2020-08-04 17:36:35,0,2,0,0,0,0,0,0,1377,296,1253,281,0.47,0.92,0.16
137,137,2020-08-05 17:06:35,2,1,0,0,0,0,0,0,1377,296,1253,281,0.73,1.29,0.32
138,138,2020-08-06 17:19:35,0,2,0,0,0,0,0,0,1377,296,1253,281,0.78,1.37,0.34
139,139,2020-08-07 16:38:35,1,1,0,0,0,0,0,0,1377,296,1253,281,1.14,1.87,0.57
140,140,2020-08-08 18:12:35,0,0,0,0,0,0,0,0,1377,296,1253,281,1.24,2.04,0.62
141,141,2020-08-09 17:19:35,0,0,0,0,0,0,0,0,1377,296,1253,281,1.33,2.18,0.66
142,142,2020-08-10 16:49:35,0,0,0,0,0,0,0,0,1377,296,1253,281,2.06,3.13,1.19
143,143,2020-08-11 16:29:35,0,0,0,0,0,0,0,0,1377,296,1253,281,2.23,3.34,1.32
144,144,2020-08-12 18:08:35,4,1,0,0,0,0,0,0,1377,296,1253,281,2.32,3.43,1.4
145,145,2020-08-13 17:42:35,0,1,0,0,0,0,0,0,1377,296,1253,281,2.47,3.56,1.55
146,146,2020-08-14 17:26:35,3,0,0,0,0,0,0,0,1377,296,1253,281,1.81,2.7,1.07
147,147,2020-08-15 16:51:35,0,0,0,0,0,0,0,0,1377,296,1253,281,1.73,2.55,1.04
148,148,2020-08-16 17:20:35,0,0,0,0,0,0,0,0,1377,296,1253,281,1.76,2.54,1.1
149,149,2020-08-17 16:15:35,4,0,0,0,0,0,0,0,1377,296,1253,281,1.3,1.94,0.77
150,150,2020-08-18 17:54:35,1,0,0,0,0,0,0,0,1377,296,1253,281,1.11,1.68,0.64
151,151,2020-08-19 16:50:35,5,0,0,0,0,0,0,0,1377,296,1253,281,0.61,1.03,0.28
152,152,2020-08-20 19:09:35,2,0,0,0,0,0,0,0,1377,296,1253,281,0.42,0.76,0.16
153,153,2020-08-21 17:18:35,0,2,0,0,0,0,0,0,1377,296,1253,281,0.49,0.86,0.21
154,154,2020-08-22 15:28:35,1,7,0,0,0,0,0,0,1377,296,1253,281,0.51,0.89,0.22
155,155,2020-08-23 17:15:35,2,0,1,0,0,0,0,0,1377,296,1253,281,0.36,0.69,0.12
156,156,2020-08-24 16:34:35,1,1,0,0,0,0,0,0,1377,296,1253,281,0.49,0.89,0.19
157,157,2020-08-25 15:48:35,0,3,0,0,0,0,0,0,1377,296,1253,281,0.65,1.14,0.28
158,158,2020-08-26 17:43:35,0,2,0,0,0,0,0,0,1377,296,1253,281,0.85,1.44,0.4
159,159,2020-08-27 23:43:35,0,1,0,0,0,0,0,0,1377,296,1253,281,1.51,2.32,0.85
160,160,2020-08-28 17:07:35,1,5,0,0,0,0,0,0,1377,296,1253,281,1.51,2.38,0.82
161,161,2020-08-29 15:45:35,1,0,0,0,0,0,0,0,1377,296,1253,281,1.93,2.93,1.11
162,162,2020-08-30 17:28:35,0,1,0,0,0,0,0,0,1377,296,1253,281,1.93,2.93,1.12
163,163,2020-08-31 17:07:35,2,1,0,0,0,0,0,0,1377,296,1253,281,1.54,2.42,0.83
164,164,2020-09-01 18:07:35,1,0,1,0,0,0,0,0,1377,296,1253,281,1.99,2.94,1.2
165,165,2020-09-02 20:07:35,1,0,0,0,0,0,0,0,1377,296,1253,281,2.22,3.18,1.42
166,166,2020-09-03 15:59:35,4,1,2,0,0,0,0,0,1377,296,1253,281,1.57,2.35,0.93
167,167,2020-09-04 17:25:35,0,1,0,0,0,0,0,0,1377,296,1253,281,2.22,3.1,1.47
168,168,2020-09-05 16:47:35,3,2,0,0,0,0,0,0,1377,296,1253,281,1.83,2.6,1.18
169,169,2020-09-06 18:17:35,0,0,0,0,0,0,0,0,1377,296,1253,281,1.87,2.6,1.24
170,170,2020-09-07 17:37:35,0,2,0,0,0,0,0,0,1377,296,1253,281,1.71,2.38,1.13
171,171,2020-09-08 17:38:35,5,0,0,0,0,0,0,0,1377,296,1253,281,1.25,1.81,0.79
172,172,2020-09-09 17:38:35,4,2,0,0,0,0,0,0,1377,296,1253,281,1.16,1.67,0.72
173,173,2020-09-10 16:54:35,0,1,0,0,0,0,0,0,1377,296,1253,281,1.21,1.72,0.79
174,174,2020-09-11 16:32:35,7,0,0,0,0,0,0,0,1377,296,1253,281,1.42,1.95,0.96
175,175,2020-09-12 16:32:35,1,0,0,0,0,0,0,0,1377,296,1253,281,1.82,2.41,1.3
176,176,2020-09-13 16:45:15,2,2,0,0,0,0,0,0,1377,296,1253,281,3.06,3.81,2.39
177,177,2020-09-14 16:58:15,0,0,0,0,0,0,0,0,1377,296,1253,281,3.01,3.74,2.35
178,178,2020-09-15 16:38:15,1,1,0,0,0,0,0,0,1377,296,1253,281,3.21,3.93,2.56
179,179,2020-09-16 16:58:15,4,0,0,0,0,0,0,0,1377,296,1253,281,3.27,3.95,2.65
180,180,2020-09-17 16:42:15,2,0,0,0,0,0,0,0,1377,296,1253,281,2.84,3.41,2.31
181,181,2020-09-18 15:55:15,11,1,0,0,0,0,0,0,1377,296,1253,281,2.2,2.66,1.77
182,182,2020-09-19 19:55:15,8,0,1,0,0,0,0,0,1377,296,1253,281,2.21,2.63,1.82
183,183,2020-09-20 18:33:15,23,0,0,0,0,0,0,0,1377,296,1253,281,1.63,1.97,1.32
184,184,2020-09-21 17:16:35,1,1,0,0,0,0,0,0,1377,296,1253,281,1.54,1.85,1.26
185,185,2020-09-22 17:16:35,9,4,1,0,0,0,0,0,1377,296,1253,281,1.39,1.66,1.13
186,186,2020-09-23 16:54:35,14,2,1,0,0,0,0,0,1377,296,1253,281,1.17,1.42,0.95
187,187,2020-09-24 16:08:35,4,3,1,0,0,0,0,0,1377,296,1253,281,1.53,1.8,1.28
188,188,2020-09-25 16:43:35,6,0,0,0,0,0,0,0,1377,296,1253,281,1.53,1.79,1.28
189,189,2020-09-26 18:04:35,21,4,0,0,0,0,0,0,1377,296,1253,281,1.32,1.56,1.09
190,190,2020-09-27 17:23:35,12,0,0,0,0,0,0,0,1377,296,1253,281,1.16,1.38,0.96
191,191,2020-09-28 16:34:35,6,3,0,0,0,0,0,0,1377,296,1253,281,1.04,1.24,0.85
192,192,2020-09-29 17:35:35,9,6,1,0,0,0,0,0,1377,296,1253,281,1.2,1.41,1
193,193,2020-09-30 16:23:35,8,11,0,0,0,0,0,0,1377,296,1253,281,1.35,1.58,1.14
194,194,2020-10-01 17:20:35,30,20,1,0,0,0,0,0,1377,296,1253,281,1.12,1.33,0.94
195,195,2020-10-02 17:46:35,10,4,0,0,0,0,0,0,1377,296,1253,281,1.12,1.32,0.93
196,196,2020-10-03 17:23:35,11,16,0,0,0,0,0,0,1377,296,1253,281,1.11,1.31,0.93
197,197,2020-10-04 17:29:35,5,3,0,0,0,0,0,0,1377,296,1253,281,1.22,1.42,1.03
198,198,2020-10-05 16:50:35,1,2,1,0,0,0,0,0,1377,296,1253,281,1.2,1.4,1.01
199,199,2020-10-06 16:50:35,24,12,1,0,0,0,0,0,1377,296,1253,281,1.1,1.29,0.92
200,200,2020-10-07 17:01:35,23,4,1,0,0,0,0,0,1377,296,1253,281,0.93,1.1,0.77
201,201,2020-10-08 17:01:35,14,7,1,0,0,0,0,0,1377,296,1253,281,0.99,1.17,0.82
202,202,2020-10-09 17:01:35,11,20,0,0,0,0,0,0,1377,296,1253,281,1.12,1.3,0.94
203,203,2020-10-10 16:56:35,13,14,0,0,0,0,0,0,1377,296,1253,281,1.26,1.46,1.08
204,204,2020-10-11 16:28:35,16,6,0,0,0,0,0,0,1377,296,1253,281,1.27,1.47,1.08
205,205,2020-10-12 16:40:35,1,4,3,0,0,0,0,0,1377,296,1253,281,1.27,1.47,1.09
206,206,2020-10-13 16:11:35,17,27,1,0,0,0,0,0,1377,296,1253,281,1.48,1.69,1.28
207,207,2020-10-14 17:34:35,10,3,0,0,0,0,0,0,1377,296,1253,281,1.71,1.93,1.49
208,208,2020-10-15 16:37:15,21,4,0,0,0,0,0,0,1377,296,1253,281,1.57,1.77,1.37
209,209,2020-10-16 17:57:15,24,19,0,0,0,0,0,0,1377,296,1253,281,1.38,1.57,1.2
210,210,2020-10-17 17:04:15,27,4,1,0,0,0,0,0,1377,296,1253,281,1.16,1.33,1
211,211,2020-10-18 16:58:15,17,3,0,0,0,0,0,0,1377,296,1253,281,1.1,1.26,0.95
212,212,2020-10-19 16:37:15,2,10,1,0,0,0,0,0,1377,296,1253,281,1.06,1.21,0.91
213,213,2020-10-20 18:07:15,39,13,1,0,0,0,0,0,1377,296,1253,281,0.86,0.99,0.73
214,214,2020-10-21 16:33:15,36,17,2,0,0,0,0,0,1377,296,1253,281,0.65,0.76,0.54
215,215,2020-10-22 16:33:15,13,15,0,0,0,0,0,0,1377,296,1253,281,0.6,0.71,0.49
216,216,2020-10-23 16:33:15,12,18,1,0,0,0,0,0,1377,296,1253,281,0.51,0.62,0.42
217,217,2020-10-24 16:58:15,12,7,2,0,0,0,0,0,1377,296,1253,281,0.45,0.56,0.36
218,218,2020-10-25 16:56:15,18,39,0,0,0,0,0,0,1377,296,1253,281,0.49,0.59,0.39
219,219,2020-10-26 16:20:15,4,32,0,0,0,0,0,0,1377,296,1253,281,0.5,0.62,0.4
220,220,2020-10-27 20:52:15,17,13,0,0,0,0,0,0,1377,296,1253,281,0.49,0.61,0.38
221,221,2020-10-28 16:57:15,10,10,1,0,0,0,0,0,1377,296,1253,281,0.61,0.74,0.48
222,222,2020-10-29 15:57:15,7,11,0,0,0,0,0,0,1377,296,1253,281,0.95,1.12,0.78
223,223,2020-10-30 17:27:15,0,4,0,0,0,0,0,0,1377,296,1253,281,1.35,1.56,1.14
224,224,2020-10-31 16:59:15,2,19,0,0,0,0,0,0,1377,296,1253,281,1.75,2.01,1.51
225,225,2020-11-01 16:59:15,19,5,0,0,0,0,0,0,1377,296,1253,281,2.37,2.68,2.09
226,226,2020-11-02 18:07:15,2,20,2,0,0,0,0,0,1377,296,1253,281,2.31,2.61,2.03
227,227,2020-11-03 16:42:15,11,6,2,0,0,0,0,0,1377,296,1253,281,2.4,2.69,2.12
228,228,2020-11-04 17:53:15,17,7,0,0,0,0,0,0,1377,296,1253,281,2.36,2.64,2.1
229,229,2020-11-05 19:46:15,32,13,1,0,0,0,0,0,1377,296,1253,281,1.87,2.1,1.65
230,230,2020-11-06 16:56:15,25,11,2,0,0,0,0,0,1377,296,1253,281,1.61,1.81,1.42
231,231,2020-11-07 17:20:15,25,25,0,0,0,0,0,0,1377,296,1253,281,1.3,1.47,1.14
232,232,2020-11-08 16:20:15,59,11,0,0,0,0,0,0,1377,296,1253,281,1.38,1.54,1.22
233,233,2020-11-09 20:20:15,0,24,1,0,0,0,0,0,1377,296,1253,281,1.28,1.44,1.14
234,234,2020-11-10 17:35:15,30,32,1,0,0,0,0,0,1377,296,1253,281,1.22,1.36,1.08
235,235,2020-11-11 21:35:15,37,11,1,0,0,0,0,0,1377,296,1253,281,1.33,1.48,1.19
236,236,2020-11-12 18:06:15,12,23,0,0,0,0,0,0,1377,296,1253,281,1.51,1.66,1.36
237,237,2020-11-13 18:25:00,22,3,3,0,0,0,0,0,1377,296,1253,281,1.36,1.51,1.22
238,238,2020-11-14 18:30:00,8,21,1,0,0,0,0,0,1377,296,1253,281,1.59,1.74,1.44
239,239,2020-11-15 06:15:00,88,1,1,0,0,0,0,0,1377,296,1253,281,1.38,1.52,1.25
240,240,2020-11-16 17:43:00,1,13,1,0,0,0,0,0,1377,296,1253,281,1.49,1.63,1.35
241,241,2020-11-17 17:02:00,30,14,1,0,0,0,0,0,1377,296,1253,281,1.65,1.79,1.51
242,242,2020-11-18 18:01:00,64,6,1,0,0,0,0,0,1377,296,1253,281,1.52,1.66,1.39
243,243,2020-11-19 16:52:00,51,15,2,0,0,0,0,0,1377,296,1253,281,1.28,1.4,1.16
244,244,2020-11-20 17:30:00,4,23,0,0,0,0,0,0,1377,296,1253,281,1.34,1.46,1.22
245,245,2020-11-21 18:25:00,59,4,4,0,0,0,0,0,1377,296,1253,281,1.16,1.27,1.06
246,246,2020-11-22 19:20:00,61,20,1,0,0,0,0,0,1377,296,1253,281,1,1.1,0.91
247,247,2020-11-23 21:27:00,37,3,3,0,0,0,0,0,1377,296,1253,281,1.04,1.14,0.95
248,248,2020-11-24 08:50:00,81,11,0,0,0,0,0,0,1377,296,1253,281,0.79,0.87,0.71
249,249,2020-11-25 17:41:00,55,12,4,0,0,0,0,0,1377,296,1253,281,0.7,0.78,0.62
250,250,2020-11-26 17:11:00,13,36,2,0,0,0,0,0,1377,296,1253,281,0.89,0.98,0.8
251,251,2020-11-27 17:15:00,39,34,2,0,0,0,0,0,1377,296,1253,281,0.96,1.05,0.87
252,252,2020-11-28 17:09:00,30,11,1,0,0,0,0,0,1377,296,1253,281,1.07,1.17,0.97
253,253,2020-11-29 17:41:00,31,9,1,0,0,0,0,0,1377,296,1253,281,1.18,1.29,1.08
254,254,2020-11-30 20:00:00,60,18,0,0,0,0,0,0,1377,296,1253,281,1.19,1.29,1.08
255,255,2020-12-01 17:43:00,12,37,0,0,0,0,0,0,1377,296,1253,281,1.29,1.4,1.18
256,256,2020-12-02 06:18:00,31,55,1,0,0,0,0,0,1377,296,1253,281,1.38,1.49,1.27
257,257,2020-12-03 17:08:00,72,24,4,0,0,0,0,0,1377,296,1253,281,1.13,1.24,1.03
258,258,2020-12-04 18:16:00,55,38,0,0,0,0,0,0,1377,296,1253,281,1.13,1.23,1.03
259,259,2020-12-05 00:00:00,57,20,0,0,0,0,0,0,1377,296,1253,281,1.05,1.15,0.96
260,260,2020-12-06 19:00:00,54,71,1,0,0,0,0,0,1377,296,1253,281,0.89,0.97,0.8
261,261,2020-12-07 18:25:00,56,14,0,0,0,0,0,0,1377,296,1253,281,0.84,0.92,0.76
262,262,2020-12-08 17:25:00,41,34,1,0,0,0,0,0,1377,296,1253,281,0.82,0.91,0.74
263,263,2020-12-09 17:30:00,61,14,1,0,0,0,0,0,1377,296,1253,281,0.81,0.9,0.73
264,264,2020-12-10 16:55:00,9,11,2,0,0,0,0,0,1377,296,1253,281,0.92,1.01,0.83
265,265,2020-12-11 00:00:00,65,43,3,0,0,0,0,0,1377,296,1253,281,0.9,0.99,0.82
266,266,2020-12-12 18:07:00,44,27,1,0,0,0,0,0,1377,296,1253,281,0.91,1,0.82
267,267,2020-12-13 18:25:00,11,19,0,0,0,0,0,0,1377,296,1253,281,1.13,1.23,1.03
268,268,2020-12-14 17:19:00,46,35,0,0,0,0,0,0,1377,296,1253,281,1.08,1.18,0.99
269,269,2020-12-15 18:03:00,39,24,2,0,0,0,0,0,1377,296,1253,281,1.07,1.17,0.98
270,270,2020-12-16 16:54:00,57,19,1,0,0,0,0,0,1377,296,1253,281,1.06,1.16,0.97
271,271,2020-12-17 17:08:00,39,11,2,0,0,0,0,0,1377,296,1253,281,1.07,1.17,0.98
272,272,2020-12-18 16:34:00,53,23,2,0,0,0,0,0,1377,296,1253,281,1.02,1.11,0.92
273,273,2020-12-19 18:05:00,38,3,0,0,0,0,0,0,1377,296,1253,281,1.02,1.11,0.92
274,274,2020-12-20 17:12:00,73,30,2,0,0,0,0,0,1377,296,1253,281,0.95,1.04,0.86
275,275,2020-12-21 00:00:00,27,2,1,0,0,0,0,0,1377,296,1253,281,0.99,1.08,0.9
276,276,2020-12-22 00:00:00,32,5,1,0,0,0,0,0,1377,296,1253,281,1.14,1.24,1.04
277,277,2020-12-23 18:05:00,54,38,1,0,0,0,0,0,1377,296,1253,281,1.51,1.63,1.4
278,278,2020-12-24 17:01:00,45,17,3,0,0,0,0,0,1377,296,1253,281,1.99,2.12,1.86
279,279,2020-12-25 18:38:00,39,19,1,0,0,0,0,0,1377,296,1253,281,2.04,2.18,1.91
280,280,2020-12-26 18:13:00,42,14,1,0,0,0,0,0,1377,296,1253,281,2.03,2.16,1.9
281,281,2020-12-27 17:08:00,54,10,1,0,0,0,0,0,1377,296,1253,281,1.91,2.03,1.79
282,282,2020-12-28 16:22:00,41,16,2,0,0,0,0,0,1377,296,1253,281,1.75,1.86,1.65
283,283,2020-12-29 00:00:00,81,45,0,0,0,0,0,0,1377,296,1253,281,1.61,1.71,1.51
284,284,2020-12-30 00:00:00,169,13,0,0,0,0,0,0,1377,296,1253,281,1.44,1.53,1.35
285,285,2020-12-31 00:00:00,195,45,0,0,0,0,0,0,1377,296,1253,281,1.25,1.33,1.17
286,286,2021-01-01 00:00:00,65,104,2,0,0,0,0,0,1377,296,1253,281,1.33,1.41,1.25
287,287,2021-01-02 00:00:00,66,33,1,0,0,0,0,0,1377,296,1253,281,1.37,1.45,1.29
288,288,2021-01-03 00:00:00,67,31,3,0,0,0,0,0,1377,296,1253,281,1.44,1.52,1.36
289,289,2021-01-04 00:00:00,52,77,3,0,0,0,0,0,1377,296,1253,281,1.48,1.56,1.4
290,290,2021-01-05 00:00:00,94,52,3,0,0,0,0,0,1377,296,1253,281,1.66,1.74,1.58
291,291,2021-01-06 00:00:00,162,150,0,0,0,0,0,0,1377,296,1253,281,1.52,1.59,1.44
292,292,2021-01-07 00:00:00,157,20,1,0,0,0,0,0,1377,296,1253,281,1.37,1.44,1.3
293,293,2021-01-08 00:00:00,158,70,1,0,0,0,0,0,1377,296,1253,281,1.4,1.47,1.33
294,294,2021-01-09 00:00:00,131,73,4,0,0,0,0,0,1377,296,1253,281,1.27,1.33,1.2
295,295,2021-01-10 00:00:00,145,40,0,0,0,0,0,0,1377,296,1253,281,1.11,1.17,1.05
296,296,2021-01-11 00:00:00,116,95,6,0,0,0,0,0,1377,296,1253,281,0.97,1.02,0.91
297,297,2021-01-12 00:00:00,252,102,9,0,0,0,0,0,1377,296,1253,281,0.81,0.86,0.76
298,298,2021-01-13 00:00:00,113,90,0,0,0,0,0,0,1377,296,1253,281,0.81,0.86,0.77
299,299,2021-01-14 00:00:00,107,107,4,0,0,0,0,0,1377,296,1253,281,0.78,0.83,0.74
300,300,2021-01-15 00:00:00,248,121,1,0,0,0,0,0,1377,296,1253,281,0.74,0.79,0.7
301,301,2021-01-16 00:00:00,87,108,0,0,0,0,0,0,1377,296,1253,281,0.88,0.93,0.83
302,302,2021-01-17 00:00:00,63,112,4,0,0,0,0,0,1377,296,1253,281,1.05,1.11,1
303,303,2021-01-18 00:00:00,30,142,3,0,0,0,0,0,1377,296,1253,281,1.18,1.24,1.12
304,304,2021-01-19 16:50:00,134,184,1,0,0,0,0,0,1377,296,1253,281,1.23,1.29,1.17
305,305,2021-01-20 16:59:00,132,129,2,0,0,0,0,0,1377,296,1253,281,1.28,1.34,1.22
306,306,2021-01-21 17:25:00,80,49,2,0,0,0,0,0,1377,296,1253,281,1.44,1.51,1.38
307,307,2021-01-22 16:58:00,200,204,8,0,0,0,0,0,1377,296,1253,281,1.31,1.38,1.25
308,308,2021-01-23 00:00:00,200,113,2,0,0,0,0,0,1377,296,1253,281,1.34,1.41,1.28
309,309,2021-01-24 00:00:00,203,103,2,0,0,0,0,0,1377,296,1253,281,1.21,1.27,1.16
310,310,2021-01-25 23:10:00,108,155,0,0,0,0,0,0,1377,296,1253,281,1.12,1.17,1.06
311,311,2021-01-26 17:07:00,156,105,3,0,0,0,0,0,1377,296,1253,281,1.19,1.24,1.13
312,312,2021-01-27 17:35:00,165,51,2,0,0,0,0,0,1377,296,1253,281,1.14,1.19,1.09
313,313,2021-01-28 17:50:00,233,144,3,0,0,0,0,0,1377,296,1253,281,1.09,1.14,1.04
314,314,2021-01-29 19:15:00,116,176,1,0,0,0,0,0,1377,296,1253,281,1.12,1.17,1.07
315,315,2021-01-30 18:00:00,271,133,6,0,0,0,0,0,1377,296,1253,281,1.02,1.07,0.97
316,316,2021-01-31 17:07:00,130,122,1,0,0,0,0,0,1377,296,1253,281,0.93,0.98,0.88
317,317,2021-02-01 17:40:00,64,132,10,0,0,0,0,0,1377,296,1253,281,0.89,0.94,0.85
318,318,2021-02-02 23:35:00,275,110,5,0,0,0,0,0,1377,296,1253,281,0.72,0.76,0.68
319,319,2021-02-03 16:42:00,155,161,2,0,0,0,0,0,1377,296,1253,281,0.65,0.68,0.61
320,320,2021-02-04 17:40:00,207,205,5,0,0,0,0,0,1377,296,1253,281,0.51,0.54,0.48
321,321,2021-02-05 17:28:00,173,53,1,0,0,0,0,0,1377,296,1253,281,0.4,0.44,0.37
322,322,2021-02-06 17:20:00,184,24,2,0,0,0,0,0,1377,296,1253,281,0.33,0.35,0.3
323,323,2021-02-07 18:30:00,37,118,1,0,0,0,0,0,1377,296,1253,281,0.37,0.4,0.34
324,324,2021-02-08 17:05:00,32,173,1,0,0,0,0,0,1377,296,1253,281,0.42,0.45,0.38
325,325,2021-02-09 18:55:00,76,49,0,0,0,0,0,0,1377,296,1253,281,0.41,0.44,0.37
326,326,2021-02-10 17:08:00,63,239,4,0,0,0,0,0,1377,296,1253,281,0.43,0.47,0.39
327,327,2021-02-11 18:00:00,38,83,6,0,0,0,0,0,1377,296,1253,281,0.57,0.61,0.52
328,328,2021-02-12 17:20:00,35,37,1,0,0,0,0,0,1377,296,1253,281,0.65,0.71,0.6
329,329,2021-02-13 18:00:00,77,142,5,0,0,0,0,0,1377,296,1253,281,0.67,0.73,0.61
330,330,2021-02-14 16:53:00,57,107,3,0,0,0,0,0,1377,296,1253,281,0.67,0.73,0.61
331,331,2021-02-15 18:06:00,49,47,2,0,0,0,0,0,1377,296,1253,281,0.75,0.82,0.69
332,332,2021-02-16 17:32:00,31,37,0,0,0,0,0,0,1377,296,1253,281,0.93,1.01,0.86
333,333,2021-02-17 17:10:00,44,34,3,0,0,0,0,0,1377,296,1253,281,1.03,1.12,0.95
334,334,2021-02-18 17:47:00,93,115,2,0,0,0,0,0,1377,296,1253,281,1.01,1.09,0.93
335,335,2021-02-19 17:20:00,46,159,5,0,0,0,0,0,1377,296,1253,281,1.13,1.22,1.04
336,336,2021-02-20 00:00:00,49,432,0,0,0,0,0,0,1377,296,1253,281,1.15,1.24,1.06
337,337,2021-02-21 17:11:00,19,71,3,0,0,0,0,0,1377,296,1253,281,1.11,1.2,1.03
338,338,2021-02-22 16:58:00,63,146,1,0,0,0,0,0,1377,296,1253,281,1.13,1.22,1.04
339,339,2021-02-23 00:00:00,89,171,2,0,0,0,0,0,1377,296,1253,281,0.97,1.06,0.89
340,340,2021-02-24 18:25:00,65,42,1,0,0,0,0,0,1377,296,1253,281,0.96,1.04,0.88
341,341,2021-02-25 17:30:00,67,181,1,0,0,0,0,0,1377,296,1253,281,0.97,1.05,0.89
342,342,2021-02-26 17:00:00,85,31,4,0,0,0,0,0,1377,296,1253,281,0.79,0.86,0.72
343,343,2021-02-27 18:00:00,47,63,3,0,0,0,0,0,1377,296,1253,281,0.76,0.83,0.69
344,344,2021-02-28 18:35:00,12,5,2,0,0,0,0,0,1377,296,1253,281,0.83,0.9,0.75
345,345,2021-03-01 16:33:00,74,34,0,0,0,0,0,0,1377,296,1253,281,0.72,0.79,0.65
346,346,2021-03-02 23:55:00,34,75,1,0,0,0,0,0,1377,296,1253,281,0.79,0.87,0.72
347,347,2021-03-03 17:52:00,66,88,1,0,0,0,0,0,1377,296,1253,281,0.75,0.82,0.68
348,348,2021-03-04 18:06:00,77,53,1,0,0,0,0,0,1377,296,1253,281,0.65,0.73,0.59
349,349,2021-03-05 18:00:00,13,10,1,0,0,0,0,0,1377,296,1253,281,0.77,0.85,0.7
350,350,2021-03-06 17:21:00,34,4,0,0,0,0,0,0,1377,296,1253,281,0.74,0.82,0.66
351,351,2021-03-07 18:36:00,38,16,1,0,0,0,0,0,1377,296,1253,281,0.78,0.86,0.7
352,352,2021-03-08 17:51:00,26,136,0,0,0,0,0,0,1377,296,1253,281,0.82,0.91,0.74
353,353,2021-03-09 18:05:00,55,122,0,0,0,0,0,0,1377,296,1253,281,0.75,0.84,0.67
354,354,2021-03-10 17:37:00,39,65,2,0,0,0,0,0,1377,296,1253,281,0.73,0.82,0.65
355,355,2021-03-11 18:55:00,33,62,0,0,0,0,0,0,1377,296,1253,281,0.72,0.81,0.64
356,356,2021-03-12 19:50:00,47,31,1,0,0,0,0,0,1377,296,1253,281,0.78,0.87,0.69
357,357,2021-03-13 19:00:00,12,26,0,0,0,0,0,0,1377,296,1253,281,0.92,1.02,0.83
358,358,2021-03-14 20:42:00,40,30,0,0,0,0,0,0,1377,296,1253,281,0.88,0.98,0.79
359,359,2021-03-15 00:00:00,30,55,2,0,0,0,0,0,1377,296,1253,281,1.13,1.25,1.02
360,360,2021-03-16 16:10:00,24,43,2,0,0,0,0,0,1377,296,1253,281,1.36,1.48,1.24
361,361,2021-03-17 23:35:00,25,25,1,0,0,0,0,0,1377,296,1253,281,1.41,1.54,1.29
362,362,2021-03-18 19:30:00,24,52,1,0,0,0,0,0,1377,296,1253,281,1.41,1.54,1.28
363,363,2021-03-19 16:43:00,55,59,1,0,0,0,0,0,1377,296,1253,281,1.28,1.4,1.16
364,364,2021-03-20 17:33:00,42,88,2,0,0,0,0,0,1377,296,1253,281,1.11,1.22,1.01
365,365,2021-03-21 17:49:00,21,88,3,0,0,0,0,0,1377,296,1253,281,1.05,1.16,0.95
366,366,2021-03-22 18:15:00,84,140,2,0,0,0,0,0,1377,296,1253,281,0.8,0.89,0.71
367,367,2021-03-23 17:41:00,70,91,4,0,0,0,0,0,1377,296,1253,281,0.69,0.77,0.61
368,368,2021-03-24 18:32:00,33,192,6,0,0,0,0,0,1377,296,1253,281,0.7,0.79,0.63
369,369,2021-03-25 22:12:00,24,38,1,0,0,0,0,0,1377,296,1253,281,0.74,0.83,0.66
370,370,2021-03-26 17:28:00,34,35,2,0,0,0,0,0,1377,296,1253,281,0.7,0.79,0.62
371,371,2021-03-27 17:00:00,13,18,0,0,0,0,0,0,1377,296,1253,281,0.74,0.82,0.65
372,372,2021-03-28 18:31:00,18,57,0,0,0,0,0,0,1377,296,1253,281,0.77,0.86,0.68
373,373,2021-03-29 17:31:00,26,64,0,0,0,0,0,0,1377,296,1253,281,0.9,1,0.8
374,374,2021-03-30 16:46:00,45,10,0,0,0,0,0,0,1377,296,1253,281,0.81,0.91,0.72
375,375,2021-03-31 19:04:00,40,78,0,0,0,0,0,0,1377,296,1253,281,0.92,1.03,0.82
376,376,2021-04-01 16:57:00,32,63,3,0,0,0,0,0,1377,296,1253,281,0.91,1.01,0.8
377,377,2021-04-02 19:05:00,18,32,0,0,0,0,0,0,1377,296,1253,281,1.1,1.22,0.99
378,378,2021-04-03 16:15:00,14,21,2,0,0,0,0,0,1377,296,1253,281,1.15,1.28,1.03
379,379,2021-04-04 19:15:00,18,13,0,0,0,0,0,0,1377,296,1253,281,1.11,1.24,1
380,380,2021-04-05 17:50:00,48,29,1,0,0,0,0,0,1377,296,1253,281,1.12,1.24,1
381,381,2021-04-06 00:00:00,16,47,1,0,0,0,0,0,1377,296,1253,281,1.29,1.43,1.17
382,382,2021-04-07 18:25:00,57,27,2,0,0,0,0,0,1377,296,1253,281,1.29,1.42,1.17
383,383,2021-04-08 17:37:00,23,59,2,0,0,0,0,0,1377,296,1253,281,1.28,1.41,1.16
384,384,2021-04-09 17:25:00,55,32,1,0,0,0,0,0,1377,296,1253,281,1.12,1.24,1.01
385,385,2021-04-10 22:47:00,20,23,1,0,0,0,0,0,1377,296,1253,281,1.3,1.43,1.18
386,386,2021-04-11 17:52:00,8,39,1,0,0,0,0,0,1377,296,1253,281,1.26,1.38,1.14
387,387,2021-04-12 17:48:00,49,93,0,0,0,0,0,0,1377,296,1253,281,1.36,1.48,1.23
388,388,2021-04-13 16:40:00,55,63,1,0,0,0,0,0,1377,296,1253,281,1.16,1.27,1.05
389,389,2021-04-14 18:17:00,61,76,0,0,0,0,0,0,1377,296,1253,281,0.98,1.09,0.88
390,390,2021-04-15 22:31:00,27,75,1,0,0,0,0,0,1377,296,1253,281,0.88,0.97,0.78
391,391,2021-04-16 18:38:00,26,27,4,0,0,0,0,0,1377,296,1253,281,0.9,1,0.81
392,392,2021-04-17 17:25:00,70,0,1,0,0,0,0,0,1377,296,1253,281,0.8,0.89,0.71
393,393,2021-04-18 20:01:00,7,8,2,0,0,0,0,0,1377,296,1253,281,0.81,0.9,0.72
394,394,2021-04-19 18:10:00,81,56,0,0,0,0,0,0,1377,296,1253,281,0.67,0.75,0.59
395,395,2021-04-20 17:44:00,15,69,1,0,0,0,0,0,1377,296,1253,281,0.77,0.86,0.69
396,396,2021-04-21 17:30:00,26,63,3,0,0,0,0,0,1377,296,1253,281,0.88,0.98,0.79
397,397,2021-04-22 17:54:00,7,28,2,0,0,0,0,0,1377,296,1253,281,1.09,1.2,0.99
398,398,2021-04-23 20:42:00,38,8,0,0,0,0,0,0,1377,296,1253,281,1.22,1.34,1.1
399,399,2021-04-24 19:12:00,46,5,0,0,0,0,0,0,1377,296,1253,281,1.14,1.25,1.02
400,400,2021-04-25 18:02:00,9,7,1,0,0,0,0,0,1377,296,1253,281,1.19,1.31,1.08
401,401,2021-04-26 21:42:00,39,11,1,0,0,0,0,0,1377,296,1253,281,1.25,1.37,1.13
402,402,2021-04-27 17:51:00,39,23,0,0,0,0,0,0,1377,296,1253,281,1.15,1.27,1.04
403,403,2021-04-28 00:00:00,48,29,2,0,0,0,0,0,1377,296,1253,281,1.05,1.16,0.94
404,404,2021-04-29 18:00:00,51,18,1,0,0,0,0,0,1377,296,1253,281,1,1.11,0.9
405,405,2021-04-30 17:54:00,58,33,4,0,0,0,0,0,1377,296,1253,281,0.89,0.99,0.8
406,406,2021-05-01 18:01:00,20,25,2,0,0,0,0,0,1377,296,1253,281,0.85,0.94,0.76
407,407,2021-05-02 00:00:00,14,11,1,0,0,0,0,0,1377,296,1253,281,0.79,0.88,0.7
408,408,2021-05-03 22:25:00,56,94,2,0,0,0,0,0,1377,296,1253,281,0.65,0.73,0.57
409,409,2021-05-04 17:02:00,22,97,1,0,0,0,0,0,1377,296,1253,281,0.79,0.89,0.7
410,410,2021-05-05 18:15:00,29,129,3,0,0,0,0,0,1377,296,1253,281,0.96,1.07,0.86
411,411,2021-05-06 17:52:00,47,50,0,0,0,0,0,0,1377,296,1253,281,0.81,0.91,0.72
412,412,2021-05-07 17:05:00,36,33,0,0,0,0,0,0,1377,296,1253,281,0.76,0.85,0.67
413,413,2021-05-08 17:00:00,11,16,1,0,0,0,0,0,1377,296,1253,281,0.75,0.84,0.66
414,414,2021-05-09 18:10:00,5,10,0,0,0,0,0,0,1377,296,1253,281,0.74,0.84,0.65
415,415,2021-05-10 17:41:00,18,65,3,0,0,0,0,0,1377,296,1253,281,0.75,0.85,0.65
416,416,2021-05-11 22:53:00,57,22,1,0,0,0,0,0,1377,296,1253,281,0.58,0.67,0.49
417,417,2021-05-12 18:42:00,66,11,1,0,0,0,0,0,1377,296,1253,281,0.31,0.38,0.25
418,418,2021-05-13 19:00:00,2,6,0,0,0,0,0,0,1377,296,1253,281,0.35,0.43,0.29
419,419,2021-05-14 20:30:00,16,20,0,0,0,0,0,0,1377,296,1253,281,0.33,0.4,0.26
420,420,2021-05-15 18:22:00,4,20,1,0,0,0,0,0,1377,296,1253,281,0.42,0.5,0.34
421,421,2021-05-16 18:35:00,0,9,1,0,0,0,0,0,1377,296,1253,281,0.54,0.64,0.45
422,422,2021-05-17 17:46:00,14,79,2,0,0,0,0,0,1377,296,1253,281,0.68,0.8,0.57
423,423,2021-05-18 18:08:00,17,48,2,0,0,0,0,0,1377,296,1253,281,0.75,0.88,0.62
424,424,2021-05-19 17:12:00,8,16,0,0,0,0,0,0,1377,296,1253,281,0.92,1.07,0.77
425,425,2021-05-20 17:21:00,8,71,3,0,0,0,0,0,1377,296,1253,281,0.98,1.15,0.83
426,426,2021-05-21 17:25:00,7,23,0,0,0,0,0,0,1377,296,1253,281,1.16,1.34,0.98
427,427,2021-05-22 00:00:00,15,0,1,0,0,0,0,0,1377,296,1253,281,1.41,1.62,1.21
428,428,2021-05-23 00:00:00,12,14,0,0,0,0,0,0,1377,296,1253,281,1.44,1.65,1.24
429,429,2021-05-24 17:36:00,21,15,1,0,0,0,0,0,1377,296,1253,281,1.19,1.38,1.01
430,430,2021-05-25 23:47:00,15,126,0,0,0,0,0,0,1377,296,1253,281,1.06,1.23,0.89
431,431,2021-05-26 17:50:00,17,10,2,0,0,0,0,0,1377,296,1253,281,1.14,1.32,0.97
432,432,2021-05-27 21:00:00,7,33,0,0,0,0,0,0,1377,296,1253,281,1.09,1.27,0.93
433,433,2021-05-28 17:37:00,18,9,1,0,0,0,0,0,1377,296,1253,281,1.09,1.27,0.93
434,434,2021-05-29 16:30:00,35,4,4,0,0,0,0,0,1377,296,1253,281,0.81,0.95,0.67
435,435,2021-05-30 22:00:00,14,2,0,0,0,0,0,0,1377,296,1253,281,0.72,0.86,0.6
436,436,2021-05-31 18:25:00,3,12,0,0,0,0,0,0,1377,296,1253,281,0.77,0.91,0.63
437,437,2021-06-01 19:52:00,6,10,0,0,0,0,0,0,1377,296,1253,281,1.21,1.39,1.04
438,438,2021-06-02 19:55:00,30,46,4,0,0,0,0,0,1377,296,1253,281,1.02,1.19,0.86
439,439,2021-06-03 17:30:00,6,15,2,0,0,0,0,0,1377,296,1253,281,1.12,1.3,0.96
440,440,2021-06-04 17:00:00,21,2,0,0,0,0,0,0,1377,296,1253,281,1.03,1.2,0.87
441,441,2021-06-05 21:30:00,6,8,0,0,0,0,0,0,1377,296,1253,281,1.05,1.22,0.89
442,442,2021-06-06 18:45:00,6,15,2,0,0,0,0,0,1377,296,1253,281,1.07,1.24,0.9
443,443,2021-06-07 20:45:00,8,4,1,0,0,0,0,0,1377,296,1253,281,1.05,1.22,0.89
444,444,2021-06-08 17:50:00,53,63,2,0,0,0,0,0,1377,296,1253,281,0.64,0.77,0.51
445,445,2021-06-09 17:20:00,7,13,2,0,0,0,0,0,1377,296,1253,281,0.72,0.86,0.59
446,446,2021-06-10 18:45:00,14,8,0,0,0,0,0,0,1377,296,1253,281,0.8,0.95,0.67
447,447,2021-06-11 17:50:00,10,21,0,0,0,0,0,0,1377,296,1253,281,0.94,1.1,0.79
448,448,2021-06-12 19:00:00,8,4,2,0,0,0,0,0,1377,296,1253,281,1.27,1.47,1.1
449,449,2021-06-13 18:05:00,9,3,1,0,0,0,0,0,1377,296,1253,281,1.43,1.64,1.24
450,450,2021-06-14 19:55:00,7,17,0,0,0,0,0,0,1377,296,1253,281,1.59,1.8,1.38
451,451,2021-06-15 20:00:00,11,2,1,0,0,0,0,0,1377,296,1253,281,1.7,1.92,1.49
452,452,2021-06-16 17:23:00,16,9,0,0,0,0,0,0,1377,296,1253,281,1.82,2.04,1.6
453,453,2021-06-17 17:30:00,23,1,0,0,0,0,0,0,1377,296,1253,281,1.85,2.08,1.64
454,454,2021-06-18 17:30:00,22,7,1,0,0,0,0,0,1377,296,1253,281,2.02,2.24,1.8
455,455,2021-06-19 17:51:00,39,43,1,0,0,0,0,0,1377,296,1253,281,1.77,1.97,1.58
456,456,2021-06-20 17:30:00,20,0,2,0,0,0,0,0,1377,296,1253,281,1.73,1.92,1.55
457,457,2021-06-21 17:07:00,19,43,1,0,0,0,0,0,1377,296,1253,281,1.79,1.97,1.61
458,458,2021-06-22 18:45:00,23,16,0,0,0,0,0,0,1377,296,1253,281,1.96,2.14,1.78
459,459,2021-06-23 19:02:00,34,11,1,0,0,0,0,0,1377,296,1253,281,1.99,2.17,1.82
460,460,2021-06-24 18:45:00,38,4,1,0,0,0,0,0,1377,296,1253,281,2.04,2.21,1.88
461,461,2021-06-25 17:37:00,56,17,4,0,0,0,0,0,1377,296,1253,281,2.07,2.23,1.91
462,462,2021-06-26 18:32:00,29,0,1,0,0,0,0,0,1377,296,1253,281,2.19,2.35,2.03
463,463,2021-06-27 18:30:00,35,2,1,0,0,0,0,0,1377,296,1253,281,2.06,2.21,1.91
464,464,2021-06-28 17:06:00,50,43,3,0,0,0,0,0,1377,296,1253,281,1.94,2.08,1.81
465,465,2021-06-29 17:25:00,75,38,1,0,0,0,0,0,1377,296,1253,281,1.85,1.97,1.72
466,466,2021-06-30 19:17:00,68,15,4,0,0,0,0,0,1377,296,1253,281,1.8,1.92,1.69
467,467,2021-07-01 19:40:00,78,14,1,0,0,0,0,0,1377,296,1253,281,1.84,1.95,1.73
468,468,2021-07-02 18:00:00,98,20,3,0,0,0,0,0,1377,296,1253,281,2,2.11,1.89
469,469,2021-07-03 21:00:00,100,15,0,0,0,0,0,0,1377,296,1253,281,1.91,2.02,1.8
470,470,2021-07-04 20:50:00,56,18,2,0,0,0,0,0,1377,296,1253,281,2,2.11,1.9
471,471,2021-07-05 19:25:00,77,28,0,0,0,0,0,0,1377,296,1253,281,1.84,1.94,1.75
472,472,2021-07-06 19:12:00,107,12,3,0,0,0,0,0,1377,296,1253,281,2.04,2.13,1.94
473,473,2021-07-07 19:33:00,118,15,2,0,0,0,0,0,1377,296,1253,281,2.07,2.16,1.98
474,474,2021-07-08 18:45:00,157,35,3,0,0,0,0,0,1377,296,1253,281,2.09,2.18,2
475,475,2021-07-09 00:00:00,233,82,6,0,0,0,0,0,1377,296,1253,281,1.89,1.97,1.81
476,476,2021-07-10 20:30:00,135,30,2,0,0,0,0,0,1377,296,1253,281,,,
477,477,2021-07-11 18:30:00,184,63,4,0,0,0,0,0,1377,296,1253,281,,,
478,478,2021-07-12 17:30:00,83,138,9,0,0,0,0,0,1377,296,1253,281,,,
479,479,2021-07-13 17:47:00,328,73,4,0,0,0,0,0,1377,296,1253,281,,,
480,480,2021-07-14 18:07:00,264,66,6,0,0,0,0,0,1377,296,1253,281,,,
481,481,2021-07-15 16:52:00,308,86,7,0,0,0,0,0,1377,296,1253,281,,,
482,482,2021-07-16 18:20:00,233,100,4,0,0,0,0,0,1377,296,1253,281,,,
483,483,2021-07-17 19:15:00,337,61,7,0,0,0,0,0,1377,296,1253,281,,,
484,484,2021-07-18 18:15:00,251,72,7,0,0,0,0,0,1377,296,1253,281,,,
485,485,2021-07-19 18:05:00,273,49,5,0,0,0,0,0,1377,296,1253,281,,,
486,486,2021-07-20 18:20:00,215,13,9,0,0,0,0,0,1377,296,1253,281,,,
487,487,2021-07-21 18:20:00,280,119,4,0,0,0,0,0,1377,296,1253,281,,,
488,488,2021-07-22 18:30:00,379,227,14,0,0,0,0,0,1377,296,1253,281,,,
489,489,2021-07-23 18:00:00,497,135,5,0,0,0,0,0,1377,296,1253,281,,,
490,490,2021-07-24 17:57:00,388,170,10,0,0,0,0,0,1377,296,1253,281,,,
491,491,2021-07-25 18:10:00,278,99,10,0,0,0,0,0,1377,296,1253,281,,,
492,492,2021-07-26 06:45:00,415,50,11,0,0,0,0,0,1377,296,1253,281,,,
493,493,2021-07-27 18:18:00,620,228,23,0,0,0,0,0,1377,296,1253,281,,,
